AAA------AAA################-----------AAAAAA----AAAAAA----#####
AAA-----AAAA################----------AAAAAAA----AAAAAA----#####
AAA-----AAAA################-----AAAAAAAAAAAAA--AAAAAA-----#####
AAAAAAAAAAAA################----AAAAAAAAAAAAAAAAAAAAAA------####
---AAAAAAAA#################----AAAAAAAAAAAAAAAAAAAAA-------####
---AAAAAAAA#################----AAAAAAAAAAAAAAAAAAAAA-------AA##
---AAAAAAA##################-AAAAAAAAAAAAA----AAAAAAAA----AAAAAA
AAA--AAAAA##################AAAAA--AAAAAA------AAAAAAAAAAAAAAAAA
AAA---AAA####################AAA-----AAA--------AAAAAAAAAAAAAAAA
AAA----AA####################AAA-----AAA-------AAAAAAAAAAAAAAAA-
AAAA---A#####################AAA-----AAAA-----AAAAAAAAAAAAAAAA--
AAAAAA#######################AAAA---AAAAAAAAAAAAAAAAA---AAAAAA--
AAAAA########################AAAAAAAAAAAAAAAAAAAAAAAA-----AAAA--
#############################---AAAAAAAAAAAAAAAAAAAAA------AA---
#############################----AAAA----AAAAAAAAAAAA--------AAA
#############################---------------AAAAAAAAA--------AAA
#############################-----------------AAAAAAA--------AAA
#############################------------------AAAAAA--------AAA
############################A-------------------AAAAA-------AAAA
############################A-------------------AAAAA-----AAAAAA
###########################A--------------------AAAAA----AAAAAAA
#########################AAA-------------------AAAAAAA-AAAAAAAAA
######################AAAAAA----AAAA----------AAAAAAAAAAAAAAAAAA
###################AAAAAAAAA---AAAAA---------AAAAAAAAAAAAAAAAAAA
################----AAAAAAA---AAAAAA--------AAAAAAAAAAAAA----AAA
#############--------AAAAAA---AAAAAA--------AAAAAAAAAAAAA----AAA
###########------------AAAAA---AAAAA--------AAAAAAAAAAAAA----AAA
#########--------------AAAAA----AAAA-------AAAAAAAAAAAAAA---AAAA
########----AAAAA------AAAAA------AAA-----AAAAAAAA----AAAAAAAAAA
######A----AAAAAAA-----AAAAA-------AAAAAAAAAAAAAA------AAAAAAAAA
####-------AAAAAA------AAAAA-------AAAAAA###AAAAA-------AAAAAAAA
#---------AAAAAAA------AAAAA-------AAAA#######AAA-------AAAAAAAA
----------AAAAAA-------AAAA-------AAAAA#########A-------AAAAAAAA
AA---------AAAA-------AAAA-------AAAAA############------AAAAAAAA
AA--------------------AAA--------AAAAA#############-----AAAAAAAA
AAA------------------AAA--------AAAAAA###############---AAAAAAAA
--AAA---------------AAAA------AAAAAAAA#################AAAAAAAAA
---AAAA-----------AAAAA----AAAAAAAAAAA##################AAAAAAAA
---AAAA----------AAAAA-----AAAAAAAAAAA#####################AAAAA
---AAAA---------AAAAAA-----AAAAAAAAAAA##########################
----AAAA------AAAAAAAA-----AAAAAAAAAAAA#########################
-----AAA--AAAAAAAAAAAA------AAAAAAA----#########################
--------AAAAAAAAAAAAAAA------AAAAAA----#########################
---------AAAAAAAAAAAAAA--------AAAA-----########################
----------AAAAAAAAAAAAAA--------AA-------#######################
----------AAAAAAAAAAAAAAA--------A-------#######################
AA---------AAAAAAAAAAAAAA--------AA-------######################
AAAAAA-------AAAAAAAAAAAAA------AAA---------####################
---AAAAAAA-----AAAAAAAAAAAA---AAAAAA---------###################
---AAAAAAA-----AAAAAAAAAAAAAAAAAAAAAA--------A##################
---AAAAAAAA-----AAAAAAAAAAAAAAAAAAAAAA-------AAA################
---AAAAAAAA-----AAAAAAAAAAAAAAAAAAAAAAA------AAAA###############
---AAAAAAAA----AAAAAAAAAAAAAAAAAAAAAAAA-------AAAA##############
---AAAAAAA-AAAAAAAAA-AAAAAAA---AAAAAAAA--------AAAA#############
----AAA----AAAAAA------AAAA-----AAAAAAAA-----------#############
-----------AAAAAA-------AA------AAAAAAAAAAA---------############
-----------AAAAAAA---------------AAAAAAAAAA----------###########
AAA--------AAAAAAAA-----------------AAAAAAA----------###########
AAA--------AAAAAAAAA----------A------AAAAAAA---------###########
AAA--------AAAAAAAAA---------AAA------AAAAA-----------##########
AAA-------AAAAAAA------------AAA----------------------##########
AAA-------AAAAAA---------------AAAAA---------AAAAAAAA-##########
AAA------AAAAAA-----------------AAAAA--------AAAAAAAAA##########
AAA-----AAAAAAA-----------------AAAAA-------AAAAAAAAAA##########
