A----------AAAA-----AAA-----AAAAAAAA###############AAAAAAAAAAAAA
-----------AAAA-----AAA-----AAAAAAAA###############AAAAAAAAAAAAA
------------AAA------A-------AAAAAAA###############AAAAAAAAAAAAA
---A-------------------------AAA----###############AAAAAAAAAAAAA
--AAAA-----------------------A------###############AAAAAAAAAAAAA
AAAAAA----------------------AA------###############AAAAAAAAAAAAA
AAAAAAA---------------------AAAA---#################AA-----AAAAA
AAAAAAAA---AAA-------------AAAAAA--#################AA------AAAA
AAAAAAAAAAAAAAA-------A----AAAAAAAA#################AA-------AAA
AAAAAAAAAAAAAAA------AA----AAAAAAAA#################AA-------AAA
AAAAAAAAAAAAAAA----AA-------AAAAAA-#################AA--------AA
----AAAAAAAA---AAAAAA--------------#################AAA-------AA
-----AAAAAAA---AAAAAA--------------#################-AAAA-----AA
------AAAAA----AAAAAA--------------#################AAAAA-----AA
-----AAAAAA----AAAAAAA------AAA---##################AAAAA-----AA
-----AAAAAAA---AAAAAAAA----AAAAA--##################AAAAAA---AAA
----AAAAAAAA--AAAAAAAAAA--AAAAAA--###################AAAA----AAA
AAAAAAAAAAAA--AAAAAAAAAAAAAAAAAAA-##################AAAAA----AAA
AAAAAAAAAAAAAAAAAAAAAAAAAAAAAAAAAA##################AAAA-----AAA
AAAAAAAAAAA---AAAAAAAAAAAAAAAAAAAA##################AAA------AAA
AAAAAAAA------AAAAAAAAAAAAAAAAAAAA##################A--------AAA
AAAAAAA--------AAAAA--AAAAAAAAAAAA##################---------AAA
AAAAAA---------AAAA----AAAAAAA---A##################A-------AAAA
--AAAA----------AAA----AAAAAA------#################AA----AAAAAA
---AAA----------AAA----AAAAAA------################AAAAAAAAAAAAA
---AAA----------AAA-----AAAAA------################AAAAAAAAAAAAA
AAAA-----------AAAA------AAAA-------##############AAAAAAAAAAAAAA
AAA-----A-----AAAAA-------AAA-------############AAAAAA---AAAAAAA
AAAA--AAAAAAAAAAAAAA-------AAAA---AAAA########--AAAAA------A----
AAAA--AAAAAAAAAAAAAA-------AAAAAAAAAAAA---------AAAAA-----------
AAAA--AAAAAAAAAAAAAA------AAAAAAAAAAAAA---------AAAAA-----------
AAAAAAAAAAAAAAAAAAAAA---AAAAAAAAAAAAAAA----------AAAA-----------
AAAAAAAAAAAAAAAAAAAAAAAAAAAAAAAAAAAAAA---AA------AAAAA-----AAA--
AAAAAAAAAAAAAAAAAAAAAAAAAAAAAAAAAAAAA---AAAA-----AAAAA---AAAAAAA
--AAAAAA-----AAAAAAAAA######AAAAAAAAA---AAAA-----AAAAAAAAAAAAAAA
--AAAAA------AAAAAA###########AAAAAAAA--AA-------AAAAAAAAAAAAAAA
-AAAAAA------AAA###############-AAAAAAA-----------AAAAA-----AAAA
AAAAAA------AAA################-----AAA-----------AAAA-------AAA
AAAA-------AAA##################----AAA-----------AA-----------A
AAA------AAAA###################-----AA----------AAA------------
AAA-----AAAA####################-------A---------AAA------------
AAA-----AAA######################------AAAA------AAAA-----------
AAA----AAA#######################------AAAAAA----AAAA-----------
AAA----AAA#######################------AAAAAAA--AAAAA-----------
AAAAA----A########################-----AAAAAAAAAAAAAAA----------
--AAAAA--#########################------AAAAAAAAAAAAAAAA--------
--AAAAA--##########################-----AAAAAAAAAAAAAAAAA-------
--AAAAA--##########################AA----AAAAAAAAAAAAAAAA-------
AAAAAA---###########################A----AAAAAAAAAAAAAAAA------A
AAAA-----############################A---AAA------AAAAAAA----AAA
AAA------#############################-AAAA--------AAAAA---AAAAA
AAA------##############################AAAA--------AA------AAAAA
AAA------################################AA--------A------------
AA--------################################A---------------------
----------##################################--------------------
---A------####################################------------------
--AAAA-----####################################-----------------
-AAAAA-----#####################################-------------AAA
-AAAAAA-----#####################################------------AAA
-AAAAAA-----######################################----------AAAA
--AAAAAA----######################################----------AAAA
---AAAAAAAA--#####################################---AAAA----AAA
-----AAAAAAAA#####################################AAAAAAAA------
-----AAAAAAAA#####################################AAAAAAAAA-----
