AAAA-------AAAAAAAAA##################################AAAAAAAAAA
AAAA-------AAAAAAAAA###################################AAAAAAAAA
AAAA------AAAAAAAAA-###################################AAAAAAAAA
-------AAAAAAAAAA---###################################--AAAAAA-
-----AAAAAAAAAAA----####################################--AAAA--
----AAAAAAAAAAA------####################################-AAA---
----AAAAAAAAAA-------#####################################AAA---
----AAAAAAAA--------A#####################################AAA---
---AAAAAAAAA--------AA#####################################AA---
AAAAAAAAAAA--------AAA######################################A---
AAAAAAAAAA---------AAAA#####################################AA--
-AAAAAAA------------AAA######################################AAA
--AAAAA--------------AA######################################AAA
--AAAA---------------AAA######################################AA
--AAAA---------------AAA######################################AA
--AAAA-------A-------AAA######################################AA
-AAAAA------AAA-----AAAA######################################AA
-AAAAA------AAA-----AAAAA####################################AAA
AAAAAA------AA------AAAAA####################################AAA
AAAA---------------AAAAAA###################################-AAA
AAA----------------AAAAA-###################################--AA
AAA----------------AAAA--##################################---AA
AAA-----------------AAA--#################################---AAA
AAA-----AAA-------------#################################---AAAA
AAAA----AAAAAAA---------################################AAAAAAAA
AAAA-----AAAAAAAA-------##############################AAAAAAAAAA
AAAA-----AAAAAAAAA-----##############################AAAAAAAAAAA
AAA-------AAAAAAAAA---#############################AAAAAAAAAAAAA
----------AAAAAAAAAA############################A----AAAAAAA----
----------AAAAAA#############################-AA-----AAAAAA-----
----------###############################------------AAAAAA-----
#####################################AAAAA---A-------AAAAAA-----
#################################AAAAAAAAAAAAA-------AAAAAAA----
################################A----AAAAAAAAAA------AAAAAAA----
##############################AA-------AAAAAAAAA-----AAAAAAA----
##############################AA---------AAAAAAAAAA--AAAAAAA----
#############################AA-------------AAAAAAAAA----AAA----
############################AAA-------------AAAAAAAAA------A----
############################AAA--------------AAAAAAAA-----AAA---
###########################AAAAA-------------AAAAAAAA-----AAAA--
###########################AAAAAA-------------AAAAAA-----AAAAAAA
##########################AAAAAAAA-------------AAA-----AAAAAAAAA
##########################-AAAAAAAA-------------------AAAAAAAAAA
#########################--AAAAAAAAA---------A--------AAAAAAAAAA
########################----AAAAAAAAA------AAAA-------AAAAAAAAAA
######################A------AAAAAAAAA----AAAAAA-------A-----AAA
#####################AAA-----AAAAAAAAA-----AAAAA--------------AA
##################-AAAAA-----AAAAAAAAA-----AAAAAA-------------AA
###############----AAAAA-----AAAAA----------AAAAA-----------AAAA
############------AAAAA-----AAAAA------------AAAA--------AAAAAAA
########AAA------AAAAAA-----AAAAA-------------AA---------AAAAAAA
####AAAAAAA-----AAAAAAA-----AAAAA------------------------AAAAAAA
AAAAAAAAAAA-----AAAAA------AAAAA------AAAA----------------AAAAAA
AAAA-AAAAA------AAAA-----AAAAAAA-----AAAAAAA---------------AAAAA
AAAA--AAAA------AAA-----AAAAAA-------AAAAAAAA-------------------
AAAAAAAAAA------AA------AAAAA--------AAAAAAAA-----------------AA
AAAAAAAAAAAA------------AAAA---------AAAAAAAA------AAAA------AAA
AAAAAAAAAAAAAAA-----------------------AAAAAA------AAAAAAA----AAA
AAAAAAAAAAAAAAAA----AAAA--------------AAAAAA-------AAAAAAA--AAAA
AAAAAAAAAAAAAAAA---AAAAA---------------AAAAA-------AAAAAAAAAAAAA
-AAAAAAAAAAAAAA----AAAAA------AAA-------AAAAA-------AAAAAAAAAAAA
--AAAAAAAAAAA-----AAAAAA-----AAAAAA-----AAAAA--------AAAAAAAAAAA
---AAAAAAA-------AAAAAAA----AAAAAAAA----AAAAA-----------AAA-----
----AAAAAA------AAAAAAAA----AAAAAAAA----AAAAA-------------------
