----AA--------################AA------------AAAAAAAAAAAA########
----AAA-------################AA------------AAAAAAAAAAAA########
---AAAAAAAA---################A----------------AAAAAAAAA########
--AAAAAAAAAA--################------------------AAAAAAAA########
-AAAAAAAAAAA--################-------------------AAAAAAA########
AAAAAAAAAAAA--################------------------AAAAAAA#########
AAAAAAAAAAAA--################AAAAAA------------AAAAAA-#########
AAAAAAAAAAA---#################AAAAAA---AAAAAAAAAAAAA-##########
AAAAAAAAAAA---#################AAAAAA---AAAAAAAAAAAA--##########
-AAAAAAAAA----##################AAAAA---AAAAAAAAAAAA-###########
-----AAAAA-----#################AAAA----AAAAAAAAAAAA############
-------AAA-----##################A------AAAAAAAAAAA#############
--------AA-----####################------AAAAAAAA###############
AA------AA-----#######################---AAAAA##################
AAA----AAAA-----################################################
AAAAAAAAAAAAAA--################################################
AAAAAAAAAAAAAAAA-###############################################
AAAAAAAAAAAAAAAA-###############################################
AAAAAAA---AAAAAAA-##############################################
AAAAAA-----AAAAAA--#############################################
-----------AAAAAAA-#############################################
------------AAAAA--A############################################
--------------------############################################
------AAA------------###########################################
----AAAAAA-----------###########################################
----AAAAAAA----------########################################AAA
---AAAAAAAA----------####################################-AAAAAA
---AAAAAAAAA---------##################################---AAAAAA
AAAAAAAAAAAAAAAAAAA---###############################----AAAAAAA
AAAAAAAAAAAAAAAAAAA---#############################-----AAAAAAAA
AAAAAA----AAAAAAAAA---###########################-----AAAAAAAAAA
AAAAAA-----AAAAAAA----#########################------AAAAAA---AA
AAAAAA-------AAA------#######################--------AAAAA-----A
AAAAAA-----------------####################---------AAAAAA------
AAAAAAA----------------#################A----------AAAAAA-------
AAAAAAA------------------###########AAAA---------AAAAAAAA-------
AAAAAAA----AAAA-------------AAAAAAAAAAA---------AAAAAAAAA-------
AAAAAAA---AAAAA-------------AAAAAAAA------------AAAAAAAA--------
AAAAAAAAAAAAAAA-------------AAAAAAAA------------AAAAAAA---------
AAAAAAAAAAAAAAA--------------AAAAAA--------------AAAAA----------
AAAAAAAAAAAAA-----------------AAAAA-------A-------AAA-----------
AAAAAAAAAAA----------------------AA------AAA--------------------
AAAAAAAAAA-------------------------------AAA--------------------
AAAAAAAAAA-----------------------AA------AAAA------AAA----------
AAAAAAAAA------------AAAAAA----AAAA------AAAAAAAAAAAAAAA--------
-AAAAA--------------AAAAAAAAAAAAAAA------AAAAAAAAAAAAAAAA-----AA
--------------------AAAAAAAAAAAAAAAA-----AAAAAAAAAAAAAAAA-----AA
-------------------AAAAAAAAAAAAAAAAA----AAAAAAAAAAAAAAAAA-----AA
---------------AAAAAAAAAAAAAAAAAAAAAAAAAAAAAAAAAAAAAAAAA------AA
-------------AAAAAAAAAAA----AAAAAAAAAAAAAAAAAAAA---------------A
AA-----------AAAAAAAAAA------AAA--AAAAAAAAAAA-------------------
AA----------AAAAAAAAAAAA-----AAAAAAAAAAAAAAA--------------------
AA--------AAAAAAAAAAAAAA----AAAAAAAAAAAAAAAA--------------------
--------AAAAAAA---AAAAAAAA-AAAAAAAAAAAAAAAA-##---AAAAAAA--------
------AAAAAAAAA----AAAAAAAAAAAAAAAAAAAAAA##########AAAAAAA------
-----AAAAAAAAAA-----AAAAAAAAAAAAAAAAAAA###############AAAA------
----AAAAAAAAAAA-----AAAAAAAAAAAAAAAAAAA###################------
---AAAAAAAAAAAAA-----AAAAAAAAAAAAAAAAA########################--
---AAAAAAAAAAAAAA------AAAAAA------AAA##########################
---AAAAAA-AAAAAAA-------AAAA--------A###########################
----AA------AAA----------AA----------###########################
--------------------AAAA-------------###########################
A-------------------AAAAA------------###########################
A------------------AAAAAA----AAA-----###########################
