#########---AA-----AAAAAA----AAAA--AAAAAAAAAAAAAAAA-------------
#########----A-----AAAAAAA---AAA--AAAAAAAAAAAAAAAAA-------------
#########----------AAAAAAAA------AAAAAAAAAAAAAAAA---------------
#########A-----AAAAA---AAAA------AAAAAAAAAAAA---------------AAAA
#########AA----AAAAA----AAAA-----AAAAAAAAAAAA--------AA----AAAAA
########AAA----AAAAA----AAAA------AAAAAAAAAA-------AAAA----AAAAA
#######AAAAA---AAAA-----AAAA---------AAAAAAA------AAAAA-----AAAA
######-AAAAA---AAAA------AAA----------AAAAA------AAAAAAA------AA
###-----AAAA---AAAA-------AAAA--------AAAA-------AAAAAAA--------
AAA-----AAAA----AA--------AAAA--------AAAA------AAAAAAAA--------
AAA----AAAA---------------AAAAA-------AAAAA------AAAAAAAA-------
AAAA--AAAA----------------AAAAA-------AAAAAA-----AAAAAAAAAA-----
AAAAAAAAAA---------------AAAAA---------AAAAA-----AAAAAAAAAAA----
AAAAAAAAAA---------------AAAAAA--------AAAAAA----AAAAAAAAAAA----
AAAAAAAAAA--------------AAAAAAA--------AAAAAAAAAAAAAAAAAAAAA----
------AAAAA-------------AAAAAAAA--------AAAAAAAAAAAAAAAAAAA---AA
--------AAAAA-----------AAAAAAAAAA------AAAAAAAAAAAAAAAAA----AAA
--------AAAAAAA---------AAAAAAAAAA------AAAAAAAAAAAAAAAAA----AAA
--------AAAAAAA---------AAAAAAA-------AAAAAAAAAAAAAAAAAA-----AAA
--------AAAAAAAA--------AAAAAA------AAAAAAAAAAAAAAA--------AAAAA
-------AAAAAAAAAAA------AAAAA-------AAAAAAAAA------------AAAAAAA
-------AAAAA--AAAAA------AAAA-------AAAAAAAA------------AAAAAA--
--------AAA----AAAA------AAAA-------AAAAAAAAA----------AAAAAAA--
---------------AAAAA------AAA-------AAAAAAAAAAAAA-----AAAAAAA---
----------------AAAA-------AA--------AAAAAAAAAAAAA---AAAAAAAA-##
----------------AAA--------AAAA----------AAAAAAAAA---AAAAAAAA###
----------------AAA------AAAAA-AAAA------AAAAAAAA----AAAAAAA####
------------------------AAAAA----AAAAAAAAAAAAAAAA---AAAAAAA#####
AAAAAAAAAAA-------------AAAAA-----AAAAAAAAAAAA------AAAAAAA#####
AAAAAAAAAAAAAAA--------AAAAAAA-----AAAAAAAAAA------AAAAAAA######
AAAAAAAAAAAAAAAA-------AAAAAAAA-----AAAAAAAAA------AAAAAAA######
AAAAAAAAAAAAAAAA--------AAAAAAA------AAAAAAAAAA---AAAAAAA#######
AAAAAAA---AAAAAA----------AAAAAA-----AAAAA-AAAAAAAAAAAAAA#######
AAAAAAA----AAAAA----AA----AAAAAA------A-----AAAAAAAAAAAA########
AAAAAAA-----AAAAA--AAA-----AAAAA------------AAAAAAAAAAAA########
AAAAAAA--######AAA--------AAAAAA-------------AAAAAAAAAAA########
################AA------AAAAA--AAAAA----------AAAAAAAAA#########
#################AA----AAAA-----AAAAA-------------AAAAA#########
#################AA----AAAA-----AAAAAA------------AAA--#########
#################AAA--AAAAA------AAAAAA----------AAAA--#########
#################AAAAAAAAA-------AAAAAAAA-------AAAAA--#########
#################AAAAAAAA---------AAAAAAAA---AAAAAAAA-##########
##################AAAAAAA-----------AAAAAAAAAAAAAAAAA-##########
##################AAAAAAA------------AAAAAAAAAAAAAAAA--#########
##################AAAAAAAAAAA---------AAAAAAAAAAA-----A#########
##################AAAAAAAAAAAAA--------AAAAAAAA-------A#########
###################AAAAAAAAAAAAA-------AAAAAAAA-------AA########
###################AAAAAAAAAAAAA--------AAAAAA--------AAAA######
####################AAAAA------A--------AAAAAAA--------AAA------
#####################AA---------AAAAAA-------AAAAA--------------
######################A----------AAAAAA------AAAAAAA------------
#########################--------AAAAA-------AAAAAAAAA----------
#####################################--------AAAAAAAAAAA--------
###########################################-AAAAAA-AAAAAAAA---AA
#############################################AAAA---AAAAAAAAAAAA
##############################################AA----AAAAAAAAAAA-
###############################################A----AAAAAAAAA---
###############################################A----AAAAAAAAA---
###############################################AAAAAAAAAAAAA----
###############################################AAAAAA-----------
################################################AAAAA-----------
################################################--AAA-----------
################################################----AA--------AA
################################################----AA-------AAA
