###############-----AAAAAAA----AAAAAAAAAAAA------AAAAAA---------
###############------AAAAAA-----AAAAAAAAAAA------AAAAAAAAAAA----
###############-------AAAAAA------AAAAAAA--------AAAAAAAAAAAA---
################-------AAAAA------------------------AAAAAAAAA---
################-------AAAAA------------------A------AAAAAAAA---
#################------AAAAA-----------------AAA-----AAAAAAA----
#################-----AAAAAA----------------AAAA-----AAAAAA-----
AA--##############---AAAAAAA---AAAAA-------AAAAAA---AAAAA-------
AA---##############-AAAAAAAAAAAAAAAA------AAAAAAAAAAAAAAA-------
AA-----#############AAAAA--AAAAAAAAA-----AAAAA----AAAAAAA-------
-------###############AA---AAAAAAAAA----AAAAA-----AAAAAAA-------
----AAAA###############----AAAAAAA----AAAAAAA------AAAAAAAAAAAAA
---AAAA-#################--AAAAAA-----AAAAAAA-------AAAAAAAAAAAA
---AAAA--##################AAAAAA-----AAAAAAA-------AAAAAAAAAAAA
--AAAAA--####################AAAA------AAAAAA-------AAAAAAAAAAAA
AAAAAAA--#######################A--------AAAAA------AAAAAAA-----
AAAAAA---##########################---------AAAAA--AAAAAAA------
AAAAAA---############################-------AAAAAAAAAAAAA-------
AAAAAAA--##############################-----AAAAAAAAAAAAAA------
AAAAAAAAA################################---AAAAAAAAAAAAAA------
AAAAAAAAA#################################--AAAAAA--AAAAAAA-----
AAAAAAAA###################################-AAAAAA--AAAAAAAA----
AAAAAAAA###################################AAAAAAA----AAAAAAA---
AAAAAAAA##################################AAAAAAAA-------AAAAAAA
--AAAAA##################################AAAAAAAAA----------AAAA
--AAAA##################################AAAAAAAAAA----------AAAA
---AA#################################AAAAAAAAAAAAA-----------AA
---################################AAAAAAAAAAAAAAAAA------------
#################################AAAAAAAAAAAAAAAAAAAAAAAA-------
###############################AAAAAAAAAAAAAAAAAAAAAAAAAAA------
#############################AAAAAAAAAAAAAAAAAAAAAAAAAAAAA------
###########################AAAA----AAAAAAAA-----AAAAAAAAA-------
##########################AAA------AAAAAAA-------AAAAAAA-----###
#########################A----------AAAAA---------AAAAA----#####
########################------------AAAAA-----------------######
#######################--------------AAA------------------######
######################-----------------------------------#######
#####################--------------------AAAA------------#######
#####################-----------AAA------AAAA------------#######
####################-----AA-----AAAAA----AAAA------------#######
####################---AAAAA---AAAAAAAA--AAAA------------#######
###################AAAAAAAAAA--AAAAAAAAAA---------------A#######
###################AAAAAAAAAAAAAAAAAAAAA---------------AA#######
###################AAAAAAAAAAAAAAAAAAAAA--------------AAA#######
##################AAAAAAAA---AAAAAAAAAAA-------------AAAA#######
##################AAAAAA-----------------------------AAAA#######
##################AAAAA------------------------------AAAA-######
##################AAAAA-----------------------------AAAAA-######
#################AAAAAA----------------------------AAAAA--######
#################AAAAAA---------------------------AAAAAA---#####
#################-AAAAAA-------------------------AAAAAAA---#####
#################AAAAAAA-----------AAAAA--------AAAAAAAA----####
#################AAAAAAAA--------AAAAAAAAAAA---AAAAAAAAA-----###
#################AAAAAAAA-------AAAAAAAAAAAAAAAAAAAAAAAAAAAA--##
################AAAAAAAAAA------AAAAAAAAAAAAAAAAAAAAAAAAAAAAA---
################AAAAAAAAAA-----AAAAAAAAAAAAAAAAAAAAAAAAAAAAAA---
################AAAAAAAAAAAA---AAAAAAAAAAAAAAAAAAAAAAAAAAAAAA---
################AA----AAAAAAAAAAAAA--------AAAAAA----AAAAAAA----
################--------AAAAAAA-------------AAAAA----AAAAAA-----
################--------AAAAAAA-------------AAAAA----AAAAAA-----
################-------AAAAAAA---------------AAA------AAAA------
################------AAAAAAA--------------------AA-------------
################----AAAAAAAA-----A--------------AAAAA-----------
################----AAAAAAAA-----AA-------A-----AAAAA-----------
