################A-A---AAA-######
################A-----AAA-######
################A--------A######
################---------#######
################--AA----A#######
###############A-AAAA---A#######
###############AAAAAAA---#######
##############AAAAAAAA--A#######
##############AAAA------########
#############-AAA-----AAA#######
############--------AAAAA#######
###########-AA----AAAAAAA#######
##########--AA----AAAAAA--######
########AA--AA-----AAAAA---#####
AA-----------AAAA----AAAA-AAAA##
AA------------AAA----AAAAAAAAAAA
------A---AA--AA----A---AAAAAAAA
--AA-AAA--AA--AA--AAAA---AAAAAAA
AAAAAAAAAA----AAAAAAAAA---------
AAAAAAAAAA----AAAAAAAAA----A----
--AAAAAA----A--AAAA-----AAAAAAA-
----AAA---AAA---AA-----AAAAAAAAA
----AA---AAAA--------AAAAAAA---A
----A---AAAAA-------AAAA---A----
AA--AA-AAAAAAA---#####AA--------
AAA--AAAAAAAA---########A---AAA-
-AAA--AA--AA---##########AAAAAA-
--AA------AA---###########AAAAA-
---AA---AAAAAAA############A----
---AAA--AAAAAAA############-----
---AAAAAAAAAAAA############--A--
--AAAAAAAAAA--A#############AAAA
